                             _                              _           _               _               _   
  __ _  _ __   _ __         | |  __ _  _   _   ___   _   _ | |_        (_)  ___        | |_   ___  ___ | |_ 
 / _` || '_ \ | '_ \  _____ | | / _` || | | | / _ \ | | | || __| _____ | | / _ \ _____ | __| / _ \/ __|| __|
| (_| || |_) || |_) ||_____|| || (_| || |_| || (_) || |_| || |_ |_____|| ||  __/|_____|| |_ |  __/\__ \| |_ 
 \__,_|| .__/ | .__/        |_| \__,_| \__, | \___/  \__,_| \__|       |_| \___|        \__| \___||___/ \__|
       |_|    |_|                      |___/                                                                
