    _                    _                                   _   
   / \    _ __   _ __   | |      __ _  _   _   ___   _   _  | |_ 
  / _ \  | '_ \ | '_ \  | |     / _` || | | | / _ \ | | | | | __|
 / ___ \ | |_) || |_) | | |___ | (_| || |_| || (_) || |_| | | |_ 
/_/   \_\| .__/ | .__/  |_____| \__,_| \__, | \___/  \__,_|  \__|
         |_|    |_|                    |___/                     
