                             _                              _                                   _               _    _                                                            _       
  __ _  _ __   _ __         | |  __ _  _   _   ___   _   _ | |_         _ __   _ __   ___    __| | _   _   ___ | |_ (_)  ___   _ __           ___ __  __  __ _  _ __ ___   _ __  | |  ___ 
 / _` || '_ \ | '_ \  _____ | | / _` || | | | / _ \ | | | || __| _____ | '_ \ | '__| / _ \  / _` || | | | / __|| __|| | / _ \ | '_ \  _____  / _ \\ \/ / / _` || '_ ` _ \ | '_ \ | | / _ \
| (_| || |_) || |_) ||_____|| || (_| || |_| || (_) || |_| || |_ |_____|| |_) || |   | (_) || (_| || |_| || (__ | |_ | || (_) || | | ||_____||  __/ >  < | (_| || | | | | || |_) || ||  __/
 \__,_|| .__/ | .__/        |_| \__,_| \__, | \___/  \__,_| \__|       | .__/ |_|    \___/  \__,_| \__,_| \___| \__||_| \___/ |_| |_|        \___|/_/\_\ \__,_||_| |_| |_|| .__/ |_| \___|
       |_|    |_|                      |___/                           |_|                                                                                                |_|             
